[x][fE][x]
[x][f][x]
[x][f][x]
[f][x][s]
[f][x][s]
[f][x][s]
[x][s][x]
[x][s][x]
[x][s][x]
[fF][x][sS]