[x][sE][x]
[x][s][x]
[x][s][x]
[s][x][f]
[s][x][f]
[s][x][f]
[x][f][x]
[x][f][x]
[x][sS][x]
[x][fF][x]